Total columns: 166

KEY COLUMNS:
============
A: DATE
B: SECTOR
C: ID
AO: ML_FUT_PRICE_20D
AR: WOLFE_D
DH: SUPPORT
DI: RESISTANCE

ALL COLUMNS:
============
A: DATE
B: SECTOR
C: ID
D: STOCK_NAME
E: CLOSE_PRICE
F: DAILY_TREND
G: DAILY_PULLBACK
H: EXTENSION_10_PERCENT
I: TREND_CHANGE_20D
J: D_RSI_DIFF
K: RSI
L: LSMA
M: D_MAC_HIGHER
N: D_RSI_DIVERGENCE
O: W_RSI_DIVERGENCE
P: W_RSI_DIFF
Q: W_RSI
R: OPPURTUNITY
S: GROUP
T: YEAR_HIGH
U: YEAR_LOW
V: MARKETCAP
W: WEEKLY_TREND
X: WEEKLY_PULLBACK
Y: WEEKLY_EXTENSION
Z: WEEKLY_LSMA
AA: WEEKLY_MAC_UPPER
AB: WEEKLY_MAC_LOWER
AC: WEEKLY_DATE
AD: D_MAC_LOWER
AE: DAILY_SLOPE
AF: WEEKLY_SLOPE
AG: AVG_VOL_5D
AH: AVG_PRICE_5D
AI: AVG_VOL_20D
AJ: AVG_PRICE_20D
AK: ML_DATE
AL: ML_CURRENTDIFF
AM: ML_UPPERRANGE
AN: ML_LOWERRANGE
AO: ML_FUT_PRICE_20D
AP: ML-RECOM
AQ: ML_CURR_PRICE
AR: WOLFE_D
AS: WOLFE_D_DATE
AT: SCORE_BUY_D
AU: SCORE_SELL_D
AV: ENTRY PRICE
AW: STOPLOSS
AX: WOLFE_D_BEARISH
AY: WEEKLY_SCORE_BUY
AZ: WEEKLY_SCORE_SELL
BA: WEEKLY-ENTRY
BB: WEEKLY-STOPLOSS
BC: WEEKLY-COMMENT
BD: DAILY-COMMENT
BE: DAILY-PERCENT-TARGET
BF: DAILY-PRICE-TARGET
BG: STATUS
BH: WEEKLY-ATR
BI: DAILY-ATR
BJ: W-ATR-BUY-STOPLOSS
BK: W-ATR-SELL-STOPLOSS
BL: COMMENT
BM: W-EMA50
BN: CATEGORY
BO: BUYHOLD_ENTRYRANGE
BP: D_BUY_BOOL_RANGE
BQ: W_BUY_BOOL_RANGE
BR: CHANGE_PERCENT
BS: IS_MB
BT: D_925AM_CLOSE
BU: DT_TRIGGERED
BV: DAY_OPEN
BW: DAY_HIGH
BX: DAY_LOW
BY: W-EMA9
BZ: W-EMA20
CA: IS_FUTURES
CB: D-EMA9
CC: D-EMA20
CD: H-EMA9
CE: H-EMA20
CF: WOFE_15MIN_BEARISH
CG: CLOSE_15MIN_DATE
CH: ML_15MIN_DATE
CI: ML_WL_GREATER
CJ: DAILY-PRICE-TARGET-DISPLAY
CK: IS_MACD_IMPROVING
CL: W_PROJECTION2
CM: W_PROJECTION3
CN: W_WLF_DT
CO: W_COMMENT
CP: SHOW
CQ: UPPER_RANGE
CR: LOWER_RANGE
CS: TOP_BOTTOM
CT: W_RSI_1
CU: W_RSI_2
CV: D_RVI
CW: AVG_LOW_RSI
CX: AVG_HIGH_RSI
CY: ZERODHA_CODE
CZ: TARGET_1
DA: TARGET_2
DB: RECOMMENDATION
DC: BUY_VOL_PATTERN
DD: SELL_VOL_PATTERN
DE: BUY_TARGET_PERCENT
DF: 1H_200EMA
DG: 5MIN_200EMA
DH: SUPPORT
DI: RESISTANCE
DJ: PROJ_FVG
DK: FVG_DATE
DL: FVG_SUCCESS_PERCENT
DM: HIEKEN_LAST_SIGNAL
DN: HIEKEN_SIGNAL_DATE
DO: HIEKEN_STOP_LOSS
DP: HIEKEN_HOURLY_STOP_LOSS
DQ: HIEKEN_HOURLY_STOP_LOSS_SHORT
DR: F&O_LIQUID
DS: FIVESTAR_BUY_TRADE
DT: FIVESTAR_SELL_TRADE
DU: D_BREAKOUT_PRICE
DV: D_VOLUME_BREAKOUT
DW: D_CANDLE_BREAKOUT
DX: D_BREAKOUT_DATE
DY: D_BREAKOUT_SLOPE
DZ: W_BREAKOUT_PRICE
EA: W_VOLUME_BREAKOUT
EB: W_CANDLE_BREAKOUT
EC: W_BREAKOUT_DATE
ED: W_BREAKOUT_SLOPE
EE: W-EMA-63
EF: D-EMA-63
EG: D_BREAKDOWN_PRICE
EH: D_VOLUME_BREAKDOWN
EI: D_CANDLE_BREAKDOWN
EJ: D_BREAKDOWN_DATE
EK: D_BREAKDOWN_SLOPE
EL: PE-RATIO
EM: ALGO_B
EN: ALG_FG_PERCENT
EO: D-EMA-200
EP: D-EMA-200-STATUS
EQ: ML_TARGET_PERCENT
ER: 5Y_HIGH
ES: D-EMA-63
ET: NIFTY50
EU: NIFTYBANK
EV: NIFTY500
EW: NIFTYFMCG
EX: NIFTYIT
EY: NIFTYFINSERV
EZ: NIFTYCPSE
FA: NIFTYPHARMA
FB: NIFTYMETAL
FC: NIFTYOILGAS
FD: NIFTYCOMMODITY
FE: TRIPLE_DIV_RESULT
FF: TRIPLE_DIV_DATE_CHECK
FG: TRIPLE_DIV_DATE_FOUND
FH: W_EMA200
FI: RSI_ABOVE_78
FJ: RESISTANCE_SLOPE_DOWNWARD
